1111111111
10000000E1
1000000001
10000C0001
1P00000001
1111111111


