1111111111
10000001E1
1000000111
10000C0001
1P00000001
1111111111
