1111111111
10000000E1
1000010001
10001C1001
1P00010001
1111111111
