1111111111
10000E00C1
1000011111
10000C0001
1P00000001
1111111111
