1111111111
1000000001
1000000001
11110C0001
1P0E000001
1111111111
