11111111111111111
100000000C0000001
10000000000000001
10000000000000001
10000000000000001
10000000000000001
10000000000000001
1P0000000000000E1
11111111111111111
