1111111111111111111111111111111111
1000000000000000110000000000000001
100000000000000011000000000000E001
1000000000000000110000000000000001
1000000000000000110000000000000001
1000000000000000110000000000000001
1000000000000000110000000000000001
1000000000000000110000000000000001
1000000000000000110000000000000001
1000000000000000110000000000000001
1000000000000000000000000000000001
1000000000000000110000000000000001
1000000000000000110000000000000001
10000000000C0000110000000000000001
1000000000000000110000000000000001
1000000000000000110000000000000001
1000000000000000110000000000000001
1000000000000000110000000000000001
10000P0000000000110000000000000001
1000000000000000110000000000000001
1000000000000000110000000000000001
1000000000000000110000000000000001
1111111111111111111111111111111111
