11111111111111
1E0000000000P1
10000000000001
10000000000001
10000000000001
10000000000001
100000C0000001
11111111111111
